WWWWWWWWWWWWWWWWWWWWWWWWWWWW
WppppppppppppWWppppppppppppW
WpWWWWpWWWWWpWWpWWWWWpWWWWpW
WppppppppppppppppppppppppppW
WpWWWWpWpWWWWWWWWWWpWpWWWWpW
WppppppWpppppWWpppppWppppppW
WWWWWWpWWWWWEWWEWWWWWpWWWWWW
EEEEEWpWWWWWEWWEWWWWWpWEEEEE
EEEEEWpWWEEEEEEEEEEWWpWEEEEE
WWWWWWpWWEWWWWWWWWEWWpWWWWWW
EEEEEEpEEEWEEEEEEWEEEpEEEEEE
WWWWWWpWWEWWWWWWWWEWWpWWWWWW
EEEEEWpWWEEEEEEEEEEWWpWEEEEE
EEEEEWpWWEWWWWWWWWEWWpWEEEEE
WWWWWWpWWEWWWWWWWWEWWpWWWWWW
WppppppppppppWWppppppppppppW
WpWWWWpWWWWWpWWpWWWWWpWWWWpW
WpWWWWpWWWWWpWWpWWWWWpWWWWpW
WpppWWpppppppEEpppppppWWpppW
WWWpWWpWWpWWWWWWWWpWWpWWpWWW
WWWpWWpWWpWWWWWWWWpWWpWWpWWW
WppppppWWppppWWppppWWppppppW
WpWWWWWWWWWWpWWpWWWWWWWWWWpW
WppppppppppppppppppppppppppW
WWWWWWWWWWWWWWWWWWWWWWWWWWWW