WWWWWWWWWWWWWWWWWWWWWWWWWWWW
WppppppppppppWWppppppppppppW
WpWWWWpWWWWWpWWpWWWWWpWWWWpW
WPWWWWpWWWWWpWWpWWWWWpWWWWPW
WpWWWWpWWWWWpWWpWWWWWpWWWWpW
WppppppppppppppppppppppppppW
WpWWWWpWWpWWWWWWWWpWWpWWWWpW
WpWWWWpWWpWWWWWWWWpWWpWWWWpW
WppppppWWppppWWppppWWppppppW
WWWWWWpWWWWWEWWEWWWWWpWWWWWW
EEEEEWpWWWWWEWWEWWWWWpWEEEEE
EEEEEWpWWEEEEEEEEEEWWpWEEEEE
WWWWWWpWWEWWWDDWWWEWWpWWWWWW
EEEEEEpEEEWEEEEEEWEEEpEEEEEE
WWWWWWpWWEWWWWWWWWEWWpWWWWWW
EEEEEWpWWEEEEEEEEEEWWpWEEEEE
EEEEEWpWWEWWWWWWWWEWWpWEEEEE
WWWWWWpWWEWWWWWWWWEWWpWWWWWW
WppppppppppppWWppppppppppppW
WpWWWWpWWWWWpWWpWWWWWpWWWWpW
WpWWWWpWWWWWpWWpWWWWWpWWWWpW
WPppWWpppppppEEpppppppWWppPW
WWWpWWpWWpWWWWWWWWpWWpWWpWWW
WWWpWWpWWpWWWWWWWWpWWpWWpWWW
WppppppWWppppWWppppWWppppppW
WpWWWWWWWWWWpWWpWWWWWWWWWWpW
WpWWWWWWWWWWpWWpWWWWWWWWWWpW
WppppppppppppppppppppppppppW
WWWWWWWWWWWWWWWWWWWWWWWWWWWW
